1111111111111111111111111111
100100000P0C0000000000000001
1000011110000000000000000001
100111C000000000000000000001
10010000000C0000000000000001
1000011111000000000000000001
100011C000000000000000000001
10010000000C0000000000000001
1000011111000000000000000001
1000000000000000000000000001
1000011111000000000000000001
100011E000000000000000000001
1111111111111111111111111111
