111111
100D11
1P00C1
100E01
111111
