11111
10E01
100C0
1P001
11011
