111111
1CC111
1P00E1
100E01
111111
