111111
1CC111
1P0001
100E01
111111
